[grid]
########################
#...#.#.......#...#....#
#####.####.#####.##.##.#
#.#.....#.....#...#....#
#.###.##.###############
#.#.#.#...#...#.#.#.#..#
#...###.#...#.#........#
#.######################
#.#.#...#.....#...#....#
###.###.#.....###.#.##.#
#.....#.#.###.#...#....#
########################
[info]
json=map_data/map08.json
