[grid]
.....#.....
....#......
###########
#.........#
#.........#
###########
#.........#
#.........#
###########
#.........#
#.........#
###########


[info]
json=map_data\map00.json