[grid]

#############
#######...###
#.#####...###
#....##...###
#.##.#.####.#
.............
#.####.####.#
#....#......#
#############

[info]
json=map_data\map07.json