[grid]
L13 H9
#############
#...........#
#..#..#..#..#
#...........#
S...........G
#...........#
#..#..#..#..#
#...........#
#############

[info]
start: 4, 0
goal: 4, 12