[grid]
######.######
#...##......#
#.....##.##.#
#.#.#.....#.#
#.....#.###.#
##.##.###.#.#
##.##.#.....#
##....#.##.##
#..##...#..##
#.###########

[info]
json=map_data\map02.json
