[grid]
L13 H9
#############
#######...###
#.#####...###
#....##...###
#.##.#.####.#
S...........G
#.####.####.#
#....#......#
#############

[info]
start: 5, 0
goal: 5, 12