[grid]
#################
#........#.....##
#...#..........##
#.........#....##
#.#............##
##.......#.....##
#.............###
#......#........#
#..#............#
#.............###
#.......#......##
#.....#...#....##
#..............##
##############.##
#################
[info]
start: 13, 14
goal: 8, 15
[rule]
────────────────────────────
　　　　　　　―  ―

　　　マップ全体が氷の床！  
　　　一度動くと、壁にぶつかるまで止まれない。  
　　　さらに、毒のせいで移動するたびにHPが減っていく。
────────────────────────────
