[grid]
###############
####.#####.##.#
#..........##.#
##.#.##.##....#
##.#.#...#.##.#
#..#.#........#
#.##.#...#.##.#
#.#...####....#
#.#.#......####
#...#.#.#..####
###############

[info]
json=map_data\map03.json

