[grid]

#############
#.###.##....#
#.....####..#
##.##..#.#..#
#..###.....##
#........#..#
#.#..#...##.#
#...######..#
#############