[grid]
L13 H9
######.######
#...##......#
#.....##.##.#
#.#.#.....#.#
#.....#..##.#
##.##.#.....#
##....#.##.##
#..##...#..##
#.###########


[info]
start : 9, 2
goal : 1, 7