[grid]
###############
####..###..##.#
#..........##.#
##.#.##.##....#
##.#.#...#.##.#
#..#.#........#
#.##.#...#.##.#
#.#...####....#
#.#.#......####
#...#.#.#..####
###############

[info]
start: 13,1
goal: 