[grid]
#############
#...........#
#..#..#..#..#
#...........#
.............
#...........#
#..#..#..#..#
#...........#
#############

[info]
json=map_data\map04.json
