[grid]
L13 H9
#############
#S###..#G...#
#.....####..#
##.##..#.#..#
#..###.....##
#........#..#
#.#..#...##.#
#...######..#
#############


[info]
start : 2, 2
goal : 9, 2
